Theseus and the Minotaur Level
00100000600000
03000002600000
00110201600000
02003012600000
01303011600000
20200101600000
66666666666666
00000000600000
00000000600000
Theseus
1
3
Minotaur
7
5
Goal
7
5
End
14
