Theseus and the Minotaur Level
00000160000000
20101160000000
03112060000000
01203060000000
01300060000000
00000060000000
66666666666666
00000060000000
00000060000000
Theseus
0
0
Minotaur
4
2
Goal
4
0
End
19
