Theseus and the Minotaur Level
01000600000000
00121600000000
02010600000000
02211600000000
00020600000000
66666666666666
00000600000000
00000600000000
00000600000000
Theseus
1
0
Minotaur
4
1
Goal
3
0
End
21
