Theseus and the Minotaur Level
00001060000000
00210060000000
00000160000000
00011160000000
01000060000000
20110060000000
66666666666666
00000060000000
00000060000000
Theseus
3
4
Minotaur
5
2
Goal
5
0
End
24
