Theseus and the Minotaur Level
00000060000000
01000060000000
21001060000000
00012060000000
00203160000000
02220260000000
66666666666666
00000060000000
00000060000000
Theseus
5
5
Minotaur
0
1
Goal
0
1
End
25
