Theseus and the Minotaur Level
00000100600000
20302132600000
01012030600000
20201021600000
00000220600000
01110021600000
00300003600000
01221300600000
66666666666666
Theseus
2
3
Minotaur
2
1
Goal
1
7
End
28
