Theseus and the Minotaur Level
00001000600000
00010030600000
01001200600000
01100202600000
20122120600000
20021220600000
00320010600000
00210000600000
66666666666666
Theseus
0
1
Minotaur
1
7
Goal
5
7
End
30
