Theseus and the Minotaur Level
00001000600000
02200111600000
03201000600000
03011223600000
01011100600000
20301220600000
20101212600000
02110020600000
66666666666666
Theseus
1
2
Minotaur
6
0
Goal
0
0
End
31
