Theseus and the Minotaur Level
00000010600000
20100000600000
00003210600000
00331002600000
02000112600000
00101030600000
02320121600000
20122120600000
66666666666666
Theseus
5
5
Minotaur
2
3
Goal
4
7
End
33
