Theseus and the Minotaur Level
00000060000000
21001160000000
01003060000000
03002060000000
00200060000000
02213060000000
66666666666666
00000060000000
00000060000000
Theseus
2
4
Minotaur
2
5
Goal
0
3
End
35
