Theseus and the Minotaur Level
00000060000000
02101360000000
00201060000000
00200360000000
00300160000000
02000060000000
66666666666666
00000060000000
00000060000000
Theseus
5
1
Minotaur
1
5
Goal
5
3
End
40
