Theseus and the Minotaur Level
00000160000000
02012060000000
00012160000000
01001160000000
20002160000000
00200060000000
66666666666666
00000060000000
00000060000000
Theseus
4
4
Minotaur
0
4
Goal
1
0
End
41
