Theseus and the Minotaur Level
00000060000000
02020160000000
01120160000000
20120260000000
01120060000000
20220060000000
66666666666666
00000060000000
00000060000000
Theseus
4
4
Minotaur
0
0
Goal
5
2
End
43
