Theseus and the Minotaur Level
00001000600000
00310222600000
02030210600000
02121120600000
00002000600000
01102021600000
01000220600000
00020010600000
66666666666666
Theseus
2
3
Minotaur
7
6
Goal
1
7
End
46
