Theseus and the Minotaur Level
00000000600000
20100000600000
02021003600000
22000001600000
22020300600000
01112010600000
01022310600000
01032002600000
66666666666666
Theseus
6
3
Minotaur
3
7
Goal
6
7
End
47
