Theseus and the Minotaur Level
00011016000000
22100006000000
02010126000000
00203116000000
00010116000000
20020216000000
00002106000000
66666666666666
00000006000000
Theseus
1
1
Minotaur
2
0
Goal
6
0
End
49
