Theseus and the Minotaur Level
01000000600000
02101220600000
20010010600000
00211230600000
00221202600000
00000210600000
00300311600000
20120001600000
66666666666666
Theseus
1
5
Minotaur
1
3
Goal
1
7
End
52
