Theseus and the Minotaur Level
01000011600000
01200300600000
00010013600000
02203031600000
00122000600000
00120300600000
02031011600000
20102022600000
66666666666666
Theseus
1
4
Minotaur
5
2
Goal
0
0
End
62
