Theseus and the Minotaur Level
01010100600000
02120000600000
00003020600000
20200000600000
02112221600000
03020030600000
20011011600000
00020020600000
66666666666666
Theseus
1
5
Minotaur
5
4
Goal
0
5
End
65
