Theseus and the Minotaur Level
00100000600000
01020130600000
00120011600000
20210111600000
20212010600000
03022012600000
00013021600000
01000100600000
66666666666666
Theseus
4
7
Minotaur
4
2
Goal
0
0
End
67
