Theseus and the Minotaur Level
00110000600000
02022321600000
00032120600000
21202012600000
00201100600000
02020010600000
00110221600000
02000220600000
66666666666666
Theseus
2
6
Minotaur
5
7
Goal
0
4
End
73
