Theseus and the Minotaur Level
00000010600000
01210112600000
23003320600000
00110000600000
00200000600000
02300100600000
00001001600000
00000022600000
66666666666666
Theseus
0
7
Minotaur
0
1
Goal
2
0
End
75
