Theseus and the Minotaur Level
01000001600000
00200321600000
22211030600000
02001102600000
02221112600000
20000010600000
03133022600000
00001220600000
66666666666666
Theseus
0
2
Minotaur
2
0
Goal
0
0
End
76
