Theseus and the Minotaur Level
00000000060000
22000200060000
00000000060000
01031000160000
03000000160000
01000002160000
00000000160000
00020000060000
66666666666666
Theseus
8
0
Minotaur
0
0
Goal
3
0
End
78
