Theseus and the Minotaur Level
00000100600000
00110001600000
03211000600000
22020221600000
00001103600000
00322010600000
01000222600000
02000010600000
66666666666666
Theseus
2
5
Minotaur
0
0
Goal
0
0
End
79
