Theseus and the Minotaur Level
00000000600000
00030200600000
02001302600000
22201101600000
02010111600000
03222011600000
01200200600000
00022220600000
66666666666666
Theseus
4
0
Minotaur
1
0
Goal
0
0
End
82
