Theseus and the Minotaur Level
00001010060000
22111112160000
01210103060000
02112320060000
21120122260000
00303222060000
03121122260000
01020232060000
66666666666666
Theseus
0
0
Minotaur
2
2
Goal
1
7
End
83
