Theseus and the Minotaur Level
00100000001000
01021320121331
02300020021100
01022130210111
01111121111100
00000110111133
02221001001001
23113201202021
00002200122200
Theseus
12
5
Minotaur
6
3
Goal
13
5
End
85
