Theseus and the Minotaur Level
00000666666666
02130666666666
00200666666666
66666666666666
66666666666666
66666666666666
66666666666666
66666666666666
66666666666666
Theseus
1
1
Minotaur
1
0
Goal
4
0
End
00
