Theseus and the Minotaur Level
00000006666666
01100006666666
02000116666666
00000206666666
66666666666666
66666666666666
66666666666666
66666666666666
66666666666666
Theseus
2
1
Minotaur
0
1
Goal
1
3
End
02
