Theseus and the Minotaur Level
00066666666666
02066666666666
01066666666666
20066666666666
66666666666666
66666666666666
66666666666666
66666666666666
66666666666666
Theseus
1
1
Minotaur
1
0
Goal
2
1
End
03
