Theseus and the Minotaur Level
00006000000000
01116000000000
20216000000000
00006000000000
66666666666666
00006000000000
00006000000000
00006000000000
00006000000000
Theseus
1
1
Minotaur
3
0
Goal
3
0
End
04
