Theseus and the Minotaur Level
00016666666666
02106666666666
02216666666666
01006666666666
66666666666666
66666666666666
66666666666666
66666666666666
66666666666666
Theseus
3
3
Minotaur
0
0
Goal
1
0
End
05
