Theseus and the Minotaur Level
00006666666666
00216666666666
01216666666666
03006666666666
66666666666666
66666666666666
66666666666666
66666666666666
66666666666666
Theseus
2
2
Minotaur
3
1
Goal
1
3
End
06
