Theseus and the Minotaur Level
00006000000000
02216000000000
03006000000000
20016000000000
66666666666666
00006000000000
00006000000000
00006000000000
00006000000000
Theseus
2
2
Minotaur
3
1
Goal
3
3
End
07
