Theseus and the Minotaur Level
00006000000000
01306000000000
01016000000000
02026000000000
66666666666666
00006000000000
00006000000000
00006000000000
00006000000000
Theseus
1
0
Minotaur
0
2
Goal
0
0
End
08
