Theseus and the Minotaur Level
00000600000000
02301600000000
20012600000000
00222600000000
66666666666666
00000600000000
00000600000000
00000600000000
00000600000000
Theseus
4
2
Minotaur
0
0
Goal
2
0
End
09
