Theseus and the Minotaur Level
00000000600000
00000300600000
00001002600000
00020000600000
00001300600000
00001212600000
01010000600000
20022000600000
66666666666666
Theseus
5
1
Minotaur
5
0
Goal
0
5
End
10
