Theseus and the Minotaur Level
00001016000000
01001206000000
02010216000000
00301306000000
00222006000000
66666666666666
00000006000000
00000006000000
00000006000000
Theseus
2
0
Minotaur
2
3
Goal
5
0
End
11
