Theseus and the Minotaur Level
00010600000000
01101600000000
21132600000000
01220600000000
02200600000000
66666666666666
00000600000000
00000600000000
00000600000000
Theseus
4
1
Minotaur
0
2
Goal
0
2
End
12
