Theseus and the Minotaur Level
00000160000000
02100060000000
00000060000000
00101260000000
02002060000000
66666666666666
00000060000000
00000060000000
00000060000000
Theseus
4
0
Minotaur
5
0
Goal
5
0
End
13
