Theseus and the Minotaur Level
00010011600000
20212200600000
20222211600000
21212201600000
00220301600000
20123201600000
01220122600000
20010220600000
66666666666666
Theseus
3
0
Minotaur
7
6
Goal
0
0
End
15
