Theseus and the Minotaur Level
01000060000000
01231260000000
00213060000000
03000060000000
20302160000000
02011060000000
66666666666666
00000060000000
00000060000000
Theseus
3
4
Minotaur
3
1
Goal
0
5
End
16
