Theseus and the Minotaur Level
00000060000000
00001060000000
00001160000000
00030260000000
01030360000000
02220060000000
66666666666666
00000060000000
00000060000000
Theseus
5
3
Minotaur
0
5
Goal
4
5
End
17
