Theseus and the Minotaur Level
00000060000000
00021360000000
00020060000000
00101060000000
01123060000000
20020060000000
66666666666666
00000060000000
00000060000000
Theseus
4
2
Minotaur
2
3
Goal
0
4
End
18
