Theseus and the Minotaur Level
66666666666666
00000006000000
01122016000000
01100016000000
01100216000000
01122106000000
00122006000000
03000006000000
00000006000000
Theseus
2
7
Minotaur
6
8
Goal
0
8
End
1001