Theseus and the Minotaur Level
00000060000000
00031160000000
00202260000000
03002060000000
20100160000000
22000260000000
66666666666666
00000060000000
00000060000000
Theseus
5
5
Minotaur
3
0
Goal
5
1
End
20
