Theseus and the Minotaur Level
00000060000000
23123060000000
00203160000000
20210060000000
00230160000000
02220260000000
66666666666666
00000060000000
00000060000000
Theseus
4
1
Minotaur
5
4
Goal
5
5
End
22
