Theseus and the Minotaur Level
00000060000000
01210260000000
01001160000000
01100160000000
02000160000000
02120060000000
66666666666666
00000060000000
00000060000000
Theseus
5
5
Minotaur
1
5
Goal
1
5
End
23
