Theseus and the Minotaur Level
00100000600000
03330222600000
01022200600000
01022220600000
01231120600000
00100111600000
01030121600000
01112222600000
66666666666666
Theseus
6
0
Minotaur
0
3
Goal
0
0
End
26
