Theseus and the Minotaur Level
00000000600000
03300020600000
20030300600000
01021110600000
03121320600000
00232021600000
00301310600000
20212020600000
66666666666666
Theseus
1
0
Minotaur
1
7
Goal
1
7
End
27
