Theseus and the Minotaur Level
00010006000000
21132016000000
00122116000000
01201216000000
02300106000000
66666666666666
00000006000000
00000006000000
00000006000000
Theseus
6
2
Minotaur
3
0
Goal
3
0
End
29
