Theseus and the Minotaur Level
00000100600000
21300010600000
00203000600000
20201011600000
23200002600000
02002330600000
02000000600000
20203010600000
66666666666666
Theseus
0
0
Minotaur
5
6
Goal
0
5
End
32
