Theseus and the Minotaur Level
00100000600000
00020032600000
20010201600000
00120300600000
03132202600000
00222220600000
66666666666666
00000000600000
00000000600000
Theseus
0
2
Minotaur
7
1
Goal
7
0
End
34
