Theseus and the Minotaur Level
00001000600000
20110200600000
00210130600000
03000010600000
01230102600000
21300000600000
02210222600000
00100000600000
66666666666666
Theseus
3
0
Minotaur
5
7
Goal
0
7
End
36
