Theseus and the Minotaur Level
00000010600000
01003020600000
00010030600000
02301002600000
01301110600000
21003113600000
00220300600000
01003200600000
66666666666666
Theseus
6
2
Minotaur
7
5
Goal
4
7
End
37
