Theseus and the Minotaur Level
01000006000000
03122206000000
00222206000000
02111016000000
00020116000000
00222306000000
02222206000000
66666666666666
00000006000000
Theseus
3
4
Minotaur
3
3
Goal
0
0
End
38
