Theseus and the Minotaur Level
00100000600000
20012212600000
20302220600000
20111321600000
22201021600000
03112111600000
01300012600000
00020211600000
66666666666666
Theseus
5
6
Minotaur
1
1
Goal
0
0
End
39
