Theseus and the Minotaur Level
00000006000000
21220006000000
00110006000000
01201306000000
22300006000000
02020226000000
00100216000000
66666666666666
00000006000000
Theseus
4
5
Minotaur
2
0
Goal
0
0
End
42
