Theseus and the Minotaur Level
01110010600000
00020011600000
01112101600000
23002121600000
01211201600000
00121222600000
02323031600000
00200102600000
66666666666666
Theseus
2
5
Minotaur
0
2
Goal
0
0
End
44
