Theseus and the Minotaur Level
00001000600000
00111010600000
00012000600000
00133022600000
00100303600000
00000101600000
00201020600000
01200021600000
66666666666666
Theseus
4
4
Minotaur
1
7
Goal
6
7
End
45
