Theseus and the Minotaur Level
00001000600000
20200130600000
01322320600000
22031213600000
03200301600000
00202020600000
03321011600000
20202002600000
66666666666666
Theseus
0
4
Minotaur
2
0
Goal
0
0
End
48
