Theseus and the Minotaur Level
00010000600000
02100101600000
03013000600000
00201030600000
00310201600000
00021122600000
00203200600000
00010002600000
66666666666666
Theseus
2
4
Minotaur
0
0
Goal
0
0
End
50
