Theseus and the Minotaur Level
00000000600000
02200000600000
00100112600000
00100201600000
02201001600000
00001001600000
20001001600000
00000200600000
66666666666666
Theseus
1
1
Minotaur
1
0
Goal
5
0
End
51
