Theseus and the Minotaur Level
01000010600000
00112100600000
22200300600000
01002020600000
20113121600000
01100201600000
20310203600000
02001120600000
66666666666666
Theseus
5
2
Minotaur
1
1
Goal
0
0
End
53
