Theseus and the Minotaur Level
00010000600000
22101030600000
20220000600000
20201200600000
23220201600000
02122201600000
00001211600000
01002000600000
66666666666666
Theseus
0
3
Minotaur
1
7
Goal
0
7
End
54
