Theseus and the Minotaur Level
01000100600000
00101200600000
23300300600000
01201000600000
03102001600000
01110023600000
00200200600000
00122100600000
66666666666666
Theseus
0
7
Minotaur
2
0
Goal
0
0
End
55
