Theseus and the Minotaur Level
00010100600000
02120021600000
00030030600000
00101213600000
22000000600000
03300000600000
01300300600000
00001012600000
66666666666666
Theseus
5
6
Minotaur
6
7
Goal
7
7
End
56
