Theseus and the Minotaur Level
00100006000000
02120216000000
02002216000000
01011016000000
01020016000000
01011206000000
00022006000000
66666666666666
00000006000000
Theseus
2
0
Minotaur
1
0
Goal
0
1
End
57
