Theseus and the Minotaur Level
00100111600000
02020000600000
23001122600000
01121012600000
01310210600000
02000011600000
22012100600000
02201001600000
66666666666666
Theseus
3
4
Minotaur
2
0
Goal
0
0
End
58
