Theseus and the Minotaur Level
01000000600000
00200102600000
00100100600000
00100120600000
01000100600000
01000002600000
01012101600000
00200002600000
66666666666666
Theseus
2
1
Minotaur
2
0
Goal
0
0
End
59
