Theseus and the Minotaur Level
00000101600000
00023121600000
02010021600000
01000201600000
21003010600000
00002010600000
20001001600000
01300020600000
66666666666666
Theseus
5
1
Minotaur
7
3
Goal
7
3
End
60
