Theseus and the Minotaur Level
00010000600000
22120100600000
00022101600000
22003130600000
00020010600000
00100211600000
00100111600000
20212201600000
66666666666666
Theseus
5
5
Minotaur
1
5
Goal
0
7
End
61
