Theseus and the Minotaur Level
01000000600000
00210000600000
02331102600000
00000103600000
00120310600000
00000020600000
00020210600000
22020021600000
66666666666666
Theseus
2
7
Minotaur
1
3
Goal
7
7
End
63
