Theseus and the Minotaur Level
00000000600000
00200103600000
00000000600000
01101012600000
02122121600000
01201010600000
66666666666666
00000000600000
00000000600000
Theseus
1
0
Minotaur
7
0
Goal
3
0
End
64
