Theseus and the Minotaur Level
01000010600000
03312001600000
00001110600000
00122000600000
00211020600000
00312200600000
00102010600000
00010020600000
66666666666666
Theseus
1
7
Minotaur
3
2
Goal
0
0
End
66
