Theseus and the Minotaur Level
00010000600000
02302100600000
20100012600000
00201300600000
23100002600000
00001210600000
00230221600000
02000020600000
66666666666666
Theseus
0
4
Minotaur
4
7
Goal
0
7
End
68
