Theseus and the Minotaur Level
01000000600000
03001020600000
00300000600000
02302000600000
00213020600000
02000002600000
20030221600000
00202202600000
66666666666666
Theseus
7
3
Minotaur
0
2
Goal
0
0
End
69
