Theseus and the Minotaur Level
01010000600000
02101002600000
01201000600000
01210000600000
01310021600000
00002001600000
02100020600000
00201000600000
66666666666666
Theseus
2
4
Minotaur
3
7
Goal
0
6
End
70
