Theseus and the Minotaur Level
00001010600000
00210100600000
00011220600000
00000211600000
01012200600000
01003121600000
00100230600000
02201000600000
66666666666666
Theseus
3
1
Minotaur
4
4
Goal
0
0
End
71
