Theseus and the Minotaur Level
00000110600000
21320012600000
01211110600000
00200201600000
20220100600000
00102020600000
00000201600000
01002002600000
66666666666666
Theseus
0
1
Minotaur
4
7
Goal
7
0
End
72
