Theseus and the Minotaur Level
01000000600000
00000203600000
00000100600000
00001000600000
02010200600000
01100010600000
20101020600000
20002100600000
66666666666666
Theseus
1
1
Minotaur
0
0
Goal
0
0
End
74
