Theseus and the Minotaur Level
00000000600000
00000102600000
01021001600000
01000011600000
03100211600000
00010100600000
20101030600000
02002002600000
66666666666666
Theseus
3
6
Minotaur
2
5
Goal
0
0
End
77
