Theseus and the Minotaur Level
00000100600000
20030011600000
00100001600000
00200101600000
23010002600000
00010201600000
01100202600000
20200202600000
66666666666666
Theseus
6
4
Minotaur
1
0
Goal
7
2
End
80
