Theseus and the Minotaur Level
00000100600000
02100032600000
00001202600000
20200002600000
02031223600000
00000030600000
22120010600000
01000202600000
66666666666666
Theseus
3
2
Minotaur
7
7
Goal
6
7
End
81
