Theseus and the Minotaur Level
00000000000000
01100000000111
01011000000111
01101000000101
01111322221021
01100100001001
00000022200000
66666666666666
00000000000000
Theseus
2
1
Minotaur
1
1
Goal
7
6
End
1002